+L++++++++
+O++++++++
+N++++++++
+DELHI++++
+O+++C++++
+N+++E++++
+++++L++++
++ANKARA++
+++++N++++
+++++D++++
