*						*	
*						*	
*						*	
*			*			*	
*		*		*		*	
*	*				*	*	
*						*	
